XXXXXXXXXXXXXXXXXXXXXXXXXXXXXXXXXXXXXXXXXXXXXXXXXXXXXXXXXXXXXXXXXXXXXXXXXXXXXXXXXXXXXXXXXXXXXXXXXXXXXXXXXXXXXXXXXXXXXXXXXXXXXXXXXXXXXXXXXXXXXXXXXXXX
X                                                                                                                                                  X
X                                                                                                                                                  X
X                                                                                                                                                  X
X                                                                                                                                                  X
X                                                                                                                                                  X
X                                                                                                                                                  X
X                                                                                                                                                  X
X                                                                                                                                                  X
X                                                                                                                                                  X
X                                                                                                                                                  X
X                                                                                                                                                  X
X                                                                                                                                                  X
X                                                                                                                                                  X
X                                                                                                                                                  X
X                                                                                                                                                  X
X                                                                                                                                                  X
X                                                                                                                                                  X
X                                                                                                                                                  X
X                                                                                                                                                  X
X                                                                                                                                                  X
X                                                                                                                                                  X
X                                                                                                                                                  X
X                                                                                                                                                  X
X                                                                                                                                                  X
X                                                                                                                                                  X
X                                                                                                                                                  X
X                                                                                                                                                  X
X                                                                                                                                                  X
X                                                                                                                                                  X
X                                                                                                                                                  X
X                                                                                                                                                  X
X                                                                                                                                                  X
X                                                                                                                                                  X
X                                                                                                                                                  X
X                                                                                                                                                  X
X                                                                                                                                                  X
X                                                                                                                                                  X
X                                                                                                                                                  X
X                                                                                                                                                  X
XP                                                                                                                                                 X
XXXXXXXXXXXXXXXXXXXXXXXXXXXXXXXXXXXXXXXXXXXXXXXXXXXXXXXXXXXXXXXXXXXXXXXXXXXXXXXXXXXXXXXXXXXXXXXXXXXXXXXXXXXXXXXXXXXXXXXXXXXXXXXXXXXXXXXXXXXXXXXXXXXX